Fecha,Fallecidos,Recuperados,Removidos totales,Totales confirmados,Activos Totales,Expuestos,Poblacion,Susceptibles,gamma,sigma,gamma promedio
2020-02-28,0,0,0,3,3,25558454,127792286,102233829,1.17377991642218E-07,0,0.020219100567384
2020-02-29,0,0,0,4,4,25558453,127792286,102233829,1.56503994979665E-07,0,sigma promedio
2020-03-01,0,0,0,5,5,25558452,127792286,102233829,1.956300013788E-07,0,0.091454731455649
2020-03-02,0,0,0,5,5,25558452,127792286,102233829,1.956300013788E-07,0,Poblacion inicial
2020-03-03,0,0,0,5,5,25558452,127792286,102233829,1.956300013788E-07,0,127792286
2020-03-04,0,0,0,5,5,25558452,127792286,102233829,1.956300013788E-07,0,Susceptibles inicial
2020-03-05,0,0,0,5,5,25558452,127792286,102233829,1.956300013788E-07,0,102233829
2020-03-06,0,0,0,6,6,25558451,127792286,102233829,2.34756010839624E-07,0,Semanas totales
2020-03-07,0,0,0,7,7,25558450,127792286,102233829,2.73882023362137E-07,0,43
2020-03-08,0,0,0,7,7,25558450,127792286,102233829,2.73882023362137E-07,0,
2020-03-09,0,0,0,7,7,25558450,127792286,102233829,2.73882023362137E-07,0,
2020-03-10,0,0,0,7,7,25558450,127792286,102233829,2.73882023362137E-07,0,
2020-03-11,0,0,0,11,11,25558446,127792286,102233829,4.30386104069082E-07,0,
2020-03-12,0,1,1,15,14,25558441,127792286,102233829,5.86890256725753E-07,0,
2020-03-13,0,1,1,26,25,25558430,127792286,102233829,1.01727688281322E-06,0,
2020-03-14,0,2,2,41,39,25558414,127792286,102233829,1.6041683963645E-06,0,
2020-03-15,0,2,2,53,51,25558402,127792286,102233829,2.07368207135955E-06,0,
2020-03-16,0,3,3,78,75,25558376,127792286,102233829,3.05183709637889E-06,0,
2020-03-17,0,3,3,89,86,25558365,127792286,102233829,3.48222587790729E-06,0,
2020-03-18,1,3,4,118,114,25558335,127792285,102233828,4.61688916746729E-06,0.008474576271186,
2020-03-19,1,3,4,164,160,25558289,127792285,102233828,6.41670496800471E-06,0.00609756097561,
2020-03-20,2,3,5,203,198,25558249,127792284,102233827,7.94264114102652E-06,0.009852216748768,
2020-03-21,2,3,5,251,246,25558201,127792284,102233827,9.82072251485932E-06,0.00796812749004,
2020-03-22,2,3,5,316,311,25558136,127792284,102233827,1.23639689529784E-05,0.006329113924051,
2020-03-23,4,3,7,367,360,25558082,127792282,102233826,1.43594499775061E-05,0.010899182561308,
2020-03-24,5,3,8,405,397,25558043,127792281,102233825,1.58462836923782E-05,0.012345679012346,
2020-03-25,6,3,9,475,466,25557972,127792280,102233824,1.85851991699498E-05,0.012631578947369,
2020-03-26,8,3,11,585,574,25557860,127792278,102233822,2.28892403354584E-05,0.013675213675214,
2020-03-27,12,3,15,717,702,25557723,127792274,102233819,2.80541423819328E-05,0.01673640167364,
2020-03-28,16,4,20,848,828,25557586,127792270,102233816,3.31799724747087E-05,0.018867924528302,
2020-03-29,20,6,26,993,967,25557434,127792266,102233813,3.88536658257633E-05,0.020140986908359,
2020-03-30,28,35,63,1094,1031,25557295,127792258,102233806,4.28057820673119E-05,0.025594149908592,
2020-03-31,29,35,64,1215,1151,25557172,127792257,102233806,4.75404712227159E-05,0.023868312757202,
2020-04-01,37,633,670,1378,708,25556402,127792249,102233799,5.39199532078107E-05,0.026850507982584,
2020-04-02,50,633,683,1510,827,25556254,127792236,102233789,5.90853416936614E-05,0.033112582781457,
2020-04-03,60,633,693,1688,995,25556064,127792226,102233781,6.60508597881113E-05,0.035545023696683,
2020-04-04,79,633,712,1890,1178,25555839,127792207,102233766,7.39557014739371E-05,0.041798941798942,
2020-04-05,94,633,727,2143,1416,25555568,127792192,102233754,8.38564809046702E-05,0.043863742417172,
2020-04-06,125,633,758,2439,1681,25555235,127792161,102233729,9.54403275884569E-05,0.051250512505125,
2020-04-07,141,633,774,2785,2011,25554870,127792145,102233716,0.000108981184408,0.050628366247756,
2020-04-08,174,633,807,3181,2374,25554434,127792112,102233690,0.000124479376064,0.054699779943414,
2020-04-09,194,633,827,3441,2614,25554150,127792092,102233674,0.000134655232125,0.056378959604766,
2020-04-10,233,633,866,3844,2978,25553701,127792053,102233642,0.000150428307821,0.060613943808533,
2020-04-11,273,634,907,4219,3312,25553277,127792013,102233610,0.000165106025345,0.064707276605831,
2020-04-12,296,1722,2018,4661,2643,25551719,127791990,102233592,0.000182414341673,0.06350568547522,
2020-04-13,332,1964,2296,5014,2718,25551081,127791954,102233563,0.00019623435893,0.066214599122457,
2020-04-14,406,2125,2531,5399,2868,25550446,127791880,102233504,0.000211307466022,0.075199110946472,
2020-04-15,449,2282,2731,5847,3116,25549789,127791837,102233470,0.000228847291068,0.076791517017274,
2020-04-16,486,2451,2937,6297,3360,25549126,127791800,102233440,0.000246466356618,0.07717960933778,
2020-04-17,546,2627,3173,6875,3702,25548300,127791740,102233392,0.000269098139602,0.079418181818182,
2020-04-18,650,2847,3497,7497,4000,25547333,127791636,102233309,0.000293455289443,0.086701347205549,
2020-04-19,686,3087,3773,8261,4488,25546286,127791600,102233280,0.000323373816452,0.083040794092725,
2020-04-20,712,3087,3799,8772,4973,25545744,127791574,102233259,0.000343384009485,0.081167350661195,
2020-04-21,857,3087,3944,9501,5557,25544841,127791429,102233143,0.000371934199943,0.090201031470372,
2020-04-22,970,3087,4057,10544,6487,25543662,127791316,102233053,0.000412783413749,0.091995447647952,
2020-04-23,1069,3087,4156,11633,7477,25542454,127791217,102232974,0.000455437836944,0.091893750537265,
2020-04-24,1221,3087,4308,12872,8564,25541033,127791065,102232852,0.00050397335143,0.094857054070852,
2020-04-25,1305,7149,8454,13842,5388,25535900,127790981,102232785,0.000542060393407,0.094278283485046,
2020-04-26,1351,8354,9705,14677,4972,25533805,127790935,102232748,0.000574806614212,0.092048783811406,
2020-04-27,1434,9086,10520,15529,5009,25532121,127790852,102232682,0.000608214256857,0.092343357589027,
2020-04-28,1569,9854,11423,16752,5329,25529968,127790717,102232574,0.000656170035152,0.093660458452722,
2020-04-29,1732,10623,12355,17799,5444,25527957,127790554,102232443,0.000697235583717,0.097308837575145,
2020-04-30,1859,11423,13282,19224,5942,25525579,127790427,102232342,0.000753126892832,0.09670203911777,
2020-05-01,1972,12377,14349,20739,6390,25522975,127790314,102232251,0.000812562015204,0.095086551907035,
2020-05-02,2061,13447,15508,22088,6580,25520449,127790225,102232180,0.000865502013699,0.093308583846433,
2020-05-03,2154,14384,16538,23471,6933,25518017,127790132,102232106,0.000919781501831,0.091772826040646,
2020-05-04,2271,15938,18209,24905,6696,25514889,127790015,102232012,0.000976096741005,0.091186508733186,
2020-05-05,2507,16810,19317,26025,6708,25512614,127789779,102231823,0.001020083633923,0.096330451488953,
2020-05-06,2704,17781,20485,27634,7149,25509797,127789582,102231666,0.001083270086391,0.097850474053702,
2020-05-07,2961,18853,21814,29616,7802,25506435,127789325,102231460,0.001161118752974,0.099979740680713,
2020-05-08,3160,20314,23474,31522,8048,25502829,127789126,102231301,0.001236019737261,0.100247446228031,
2020-05-09,3353,21824,25177,33460,8283,25499150,127788933,102231146,0.001312200602765,0.100209205020921,
2020-05-10,3465,23100,26565,35022,8457,25496177,127788821,102231057,0.001373617699626,0.098937810519102,
2020-05-11,3573,24466,28039,36327,8288,25493377,127788713,102230970,0.001424958333296,0.098356594268726,
2020-05-12,3926,25581,29507,38324,8817,25489841,127788360,102230688,0.001503500943768,0.102442333785617,
2020-05-13,4220,26990,31210,40186,8976,25486217,127788066,102230453,0.001576773830341,0.105011695615388,
2020-05-14,4477,28475,32952,42595,9643,25482015,127787809,102230247,0.001671571106131,0.105106233125954,
2020-05-15,4767,30451,35218,45032,9814,25477254,127787519,102230015,0.001767537427699,0.10585805649316,
2020-05-16,5045,31848,36893,47144,10251,25473411,127787241,102229793,0.001850714064167,0.107012557271339,
2020-05-17,5177,33329,38506,49219,10713,25469697,127787109,102229687,0.001932453299307,0.105182957800849,
2020-05-18,5332,35388,40720,51633,10913,25465038,127786954,102229563,0.002027603493072,0.10326729029884,
2020-05-19,5666,37325,42991,54346,11355,25459987,127786620,102229296,0.002134565111915,0.104257903065543,
2020-05-20,6090,38876,44966,56594,11628,25455679,127786196,102228957,0.002223236708791,0.107608580414885,
2020-05-21,6510,40657,47167,59567,12400,25450421,127785776,102228621,0.002340511380932,0.109288700119194,
2020-05-22,6989,42725,49714,62527,12813,25444818,127785297,102228238,0.002457356936096,0.111775712892031,
2020-05-23,7179,44919,52098,65856,13758,25439067,127785107,102228086,0.002588774187355,0.10901056851312,
2020-05-24,7394,47424,54818,68620,13802,25433540,127784892,102227914,0.002698012152457,0.107752841737103,
2020-05-25,7633,49890,57523,71105,13582,25428303,127784653,102227722,0.002796293563121,0.107348287743478,
2020-05-26,8134,52219,60353,74560,14207,25421917,127784152,102227322,0.002932902345641,0.109093347639485,
2020-05-27,8597,54383,62980,78023,15043,25415735,127783689,102226951,0.003069869905395,0.11018545813414,
2020-05-28,9044,56638,65682,81400,15718,25409566,127783242,102226594,0.003203517919196,0.111105651105651,
2020-05-29,9415,59610,69025,84627,15602,25402922,127782871,102226297,0.003331388412719,0.111252909827833,
2020-05-30,9779,61871,71650,87512,15862,25397339,127782507,102226006,0.003445715316868,0.111744675015998,
2020-05-31,9930,64326,74256,90664,16408,25391551,127782356,102225885,0.003570636547567,0.109525280155299,
2020-06-01,10167,67491,77658,93435,15777,25385331,127782119,102225695,0.003680668965869,0.108813613742174,
2020-06-02,10637,70308,80945,97326,16381,25378059,127781649,102225319,0.003835045067867,0.109292480940345,
2020-06-03,11729,73271,85000,101238,16238,25369873,127780557,102224446,0.003990481150615,0.115855706355321,
2020-06-04,12545,75448,87993,105680,17687,25362275,127779741,102223793,0.004166818631215,0.118707418622256,
2020-06-05,13170,78590,91760,110026,18266,25354037,127779116,102223293,0.004339585053063,0.119698980241034,
2020-06-06,13511,81544,95055,113619,18564,25347081,127778775,102223020,0.004482527988134,0.118914970207448,
2020-06-07,13699,84419,98118,117103,18985,25340496,127778587,102222870,0.004621180264191,0.116982485504214,
2020-06-08,14053,88217,102270,120102,17832,25333275,127778233,102222586,0.004740879337551,0.117008875788913,
2020-06-09,14649,91412,106061,124301,18240,25325165,127777637,102222110,0.004908200992965,0.11785102292017,
2020-06-10,15357,94733,110090,129184,19094,25316112,127776929,102221543,0.005102837276119,0.11887695070597,
2020-06-11,15944,98064,114008,133974,19966,25307286,127776342,102221074,0.005293890463007,0.119008165763506,
2020-06-12,16448,101767,118215,139196,20981,25297757,127775838,102220670,0.005502305994954,0.118164315066525,
2020-06-13,16872,104975,121847,142690,20843,25290546,127775414,102220331,0.00564202923891,0.118242343541944,
2020-06-14,17141,108110,125251,146837,21586,25282941,127775145,102220116,0.005807749976555,0.116734882897362,
2020-06-15,17580,113006,130586,150264,19678,25274091,127774706,102219765,0.005945377026616,0.116994090400894,
2020-06-16,18310,116178,134488,154863,20375,25265444,127773976,102219181,0.006129439086841,0.11823353544746,
2020-06-17,19080,119355,138435,159793,21358,25256413,127773206,102218565,0.006326828754344,0.119404479545412,
2020-06-18,19747,123095,142842,165455,22613,25246211,127772539,102218031,0.006553656705159,0.119349672116285,
2020-06-19,20394,127332,147726,170485,22759,25236167,127771892,102217514,0.006755582176961,0.119623427280992,
2020-06-20,20781,131686,152467,175202,22735,25226632,127771505,102217204,0.006945120537692,0.11861165968425,
2020-06-21,21825,135279,157104,180545,23441,25216443,127770461,102216369,0.007159812349426,0.120883990140962,
2020-06-22,22584,140118,162702,185122,22420,25206116,127769702,102215762,0.007344328654204,0.121995224770692,
2020-06-23,23377,144448,167825,191410,23585,25194547,127768909,102215127,0.007597278887372,0.122130505198266,
2020-06-24,24324,149318,173642,196847,23205,25183103,127767962,102214370,0.00781663006342,0.123568050313187,
2020-06-25,25060,116862,141922,202951,61029,25208572,127767226,102213781,0.008050872536532,0.123478080916083,
2020-06-26,25779,120562,146341,208392,62051,25198568,127766507,102213206,0.008269993755201,0.123704364850858,
2020-06-27,26381,123797,150178,212802,62624,25190201,127765905,102212724,0.008447808733245,0.123969699532899,
2020-06-28,26648,126843,153491,216852,63361,25182785,127765638,102212510,0.008611120652462,0.12288565473226,
2020-06-29,27121,131264,158385,220657,62272,25173991,127765165,102212132,0.008765276828771,0.122910218121338,
2020-06-30,27769,134957,162726,226089,63363,25164088,127764517,102211614,0.008984589467339,0.122823312943133,
2020-07-01,28510,138319,166829,231770,64941,25154156,127763776,102211021,0.009213984361073,0.123009880484964,
2020-07-02,29189,142593,171782,238511,66729,25142326,127763097,102210478,0.00948643335545,0.122380099869608,
2020-07-03,29843,147205,177048,245251,68203,25130190,127762443,102209954,0.00975921789688,0.121683499761469,
2020-07-04,30366,152309,182675,252165,69490,25117544,127761920,102209536,0.01003939716399,0.120421152816608,
2020-07-05,30639,155604,186243,256848,70605,25109238,127761647,102209318,0.010229223204623,0.119288450756868,
2020-07-06,31119,159657,190776,261750,70974,25099707,127761167,102208934,0.010428408586602,0.118888252148997,
2020-07-07,32014,163646,195660,268008,72348,25088386,127760272,102208218,0.010682552476672,0.119451658159458,
2020-07-08,32796,167795,200591,275003,74412,25076304,127759490,102207592,0.010966648035532,0.119256880834027,
2020-07-09,33526,172230,205756,282283,76527,25063713,127758760,102207008,0.011262616995335,0.118767336325602,
2020-07-10,34191,177097,211288,289174,77886,25051157,127758095,102206476,0.011543339096075,0.118236770940679,
2020-07-11,34730,180852,215582,295268,79686,25040661,127757556,102206045,0.011791541764812,0.117621957001775,
2020-07-12,35006,184764,219770,299750,79980,25031936,127757280,102205824,0.011974703035355,0.116783986655546,
2020-07-13,35491,189063,224554,304435,79881,25022370,127756795,102205436,0.012166513403806,0.116579893901818,
2020-07-14,36327,193976,230303,311486,81183,25009403,127755959,102204767,0.012454755517355,0.11662482422966,
2020-07-15,36906,199129,236035,317635,81600,24997406,127755380,102204304,0.012706718449106,0.116189966470949,
2020-07-16,37574,203464,241038,324041,83003,24985863,127754712,102203770,0.012968973695245,0.115954462552578,
2020-07-17,38310,208436,246746,331298,84552,24972751,127753976,102203181,0.013266379823352,0.115636073867032,
2020-07-18,38888,213006,251894,338913,87019,24959873,127753398,102202718,0.013578314280686,0.114743311705364,
2020-07-19,39184,217423,256607,344224,87617,24949789,127753102,102202482,0.01379666978346,0.113832853025937,
2020-07-20,39485,222068,261553,349396,87843,24939611,127752801,102202241,0.014009681225581,0.113009307490641,
2020-07-21,40400,227165,267565,356255,88690,24926557,127751886,102201509,0.014292186441954,0.113401917166075,
2020-07-22,41190,231403,272593,362274,89681,24915352,127751096,102200877,0.014540191926648,0.113698471322811,
2020-07-23,41908,236209,278117,370712,92595,24901247,127750378,102200302,0.01488728656842,0.113047325147284,
2020-07-24,42645,242692,285337,378285,92948,24886306,127749641,102199713,0.015200528354831,0.1127324636187,
2020-07-25,43374,247178,290552,385036,94484,24874194,127748912,102199130,0.015479335732446,0.112649206827414,
2020-07-26,43680,251505,295185,390516,95331,24864020,127748606,102198885,0.0157060684475,0.111852011185201,
2020-07-27,44022,256777,300799,395489,94690,24853365,127748264,102198611,0.01591289549725,0.111310301930016,
2020-07-28,44876,261457,306333,402697,96364,24840452,127747410,102197928,0.016211339471601,0.111438625070462,
2020-07-29,45361,267147,312508,408449,95941,24828428,127746925,102197540,0.016450860279998,0.111056704753837,
2020-07-30,46000,272187,318187,416179,97992,24814891,127746286,102197029,0.016771341046793,0.110529363567119,
2020-07-31,46688,278618,325306,424637,99331,24799177,127745598,102196478,0.017123027913386,0.109948026196493,
2020-08-01,47472,284847,332319,434193,101874,24782451,127744814,102195851,0.017520179904724,0.109333867657931,
2020-08-02,47746,289394,337140,439046,101906,24772722,127744540,102195632,0.017722961570392,0.108749424889419,
2020-08-03,48012,295677,343689,443813,100124,24761353,127744274,102195419,0.017923616694128,0.108180697726295,
2020-08-04,48869,300254,349123,449961,100838,24749599,127743417,102194734,0.01818053698567,0.108607190400946,
2020-08-05,49698,304708,354406,456100,101694,24738012,127742588,102194070,0.018437213143886,0.10896294672221,
2020-08-06,50517,308848,359365,462690,103325,24726299,127741769,102193415,0.018712464813274,0.109181093172535,
2020-08-07,51311,313386,364697,469407,104710,24714091,127740975,102192780,0.018993496463212,0.109310257409881,
2020-08-08,52006,318638,370644,475902,105258,24701510,127740280,102192224,0.01926610964269,0.109278801097705,
2020-08-09,52298,322465,374763,480278,105515,24692957,127739988,102191990,0.019449999447211,0.108891100570919,
2020-08-10,53003,327993,380996,485836,104840,24681025,127739283,102191426,0.019684595757267,0.1090964852337,
2020-08-11,53929,332800,386729,492522,105793,24668420,127738357,102190686,0.019965688925355,0.109495616439469,
2020-08-12,54666,336635,391301,498380,107079,24657843,127737620,102190096,0.020211824692046,0.109687387134315,
2020-08-13,55293,341507,396800,505751,108951,24644848,127736993,102189594,0.020521571080495,0.109328503552143,
2020-08-14,55908,345653,401561,511369,109808,24634346,127736378,102189102,0.020758375318752,0.109330053249219,
2020-08-15,56543,351372,407915,517714,109799,24621520,127735743,102188594,0.021026890297593,0.10921667175313,
2020-08-16,56757,355101,411858,522162,110304,24613086,127735529,102188423,0.021214812315693,0.108696151768991,
2020-08-17,57023,359347,416370,525733,109363,24604950,127735263,102188210,0.02136696071319,0.108463801967919,
2020-08-18,57774,363307,421081,531239,110158,24594582,127734512,102187610,0.021599838533544,0.108753310656785,
2020-08-19,58481,367537,426018,537031,111013,24583712,127733805,102187044,0.021844992326627,0.10889687932354,
2020-08-20,59106,371638,430744,543806,113062,24572086,127733180,102186544,0.022131047400697,0.108689495886401,
2020-08-21,59610,376409,436019,549734,113715,24560782,127732676,102186141,0.022382593518399,0.10843426093347,
2020-08-22,60254,380492,440746,556216,115470,24549444,127732032,102185626,0.022656969339102,0.108328419175284,
2020-08-23,60480,383872,444352,560164,115812,24541845,127731806,102185445,0.022824852817708,0.107968380688513,
2020-08-24,60800,389124,449924,563705,113781,24532668,127731486,102185189,0.022977729124284,0.10785783344125,
2020-08-25,61450,393101,454551,568621,114070,24522995,127730836,102184669,0.023187257510757,0.10806846739744,
2020-08-26,62076,396758,458834,573888,115054,24513320,127730210,102184168,0.023411271912577,0.108167447306792,
2020-08-27,62594,400479,463073,579914,116841,24502951,127729692,102183754,0.023667108504604,0.107936694061533,
2020-08-28,63146,404667,467813,585738,117925,24492277,127729140,102183312,0.02391521212993,0.107805879079042,
2020-08-29,63819,409127,472946,591712,118766,24481035,127728467,102182774,0.024170219927385,0.10785483478449,
2020-08-30,64158,412580,476738,595841,119103,24473047,127728128,102182502,0.024346825305406,0.107676376751516,
2020-08-31,64414,416738,481152,599560,118408,24464862,127727872,102182298,0.024506984752254,0.107435452665288,
2020-09-01,65241,421373,486614,606036,119422,24452759,127727045,102181636,0.024783951782292,0.107652020672039,
2020-09-02,65816,424990,490806,610957,120151,24443531,127726470,102181176,0.024994629458404,0.107726075648532,
2020-09-03,66329,430287,496616,616894,120278,24431681,127725957,102180766,0.025249756658169,0.107520903104909,
2020-09-04,66851,434667,501518,623090,121572,24420479,127725435,102180348,0.025515060535872,0.107289476640614,
2020-09-05,67326,438754,506080,629409,123329,24409503,127724960,102179968,0.025785408248583,0.106967011911174,
2020-09-06,67558,442268,509826,634023,124197,24401097,127724728,102179782,0.025983380993076,0.106554494079868,
2020-09-07,67781,446715,514496,637509,123013,24392896,127724505,102179604,0.026135027181684,0.106321636243567,
2020-09-08,68484,451159,519643,642860,123217,24382257,127723802,102179042,0.026365893854699,0.106530193199141,
2020-09-09,69095,454982,524077,647507,123430,24373054,127723191,102178553,0.026566510704814,0.106709271096683,
2020-09-10,69649,458850,528499,652364,123865,24363664,127722637,102178110,0.026776103955464,0.106764015181708,
2020-09-11,70183,463764,533947,658299,124352,24352175,127722103,102177682,0.027032451926779,0.106612648659652,
2020-09-12,70604,467525,538129,663973,125844,24342234,127721682,102177346,0.027276584392378,0.106335649190554,
2020-09-13,70821,471623,542444,668381,125937,24333468,127721465,102177172,0.027467560316516,0.105959026363706,
2020-09-14,71049,475795,546844,671716,124872,24325687,127721237,102176990,0.027613444175287,0.105772379993926,
2020-09-15,71678,481068,552746,676487,123741,24314889,127720608,102176486,0.027821924253901,0.105956212018856,
2020-09-16,71978,485024,557002,680931,123929,24306129,127720308,102176246,0.028014785900297,0.105705277039818,
2020-09-17,72179,488416,560595,684113,123518,24299313,127720107,102176086,0.028153594301205,0.105507423481209,
2020-09-18,72803,492192,564995,688954,123959,24289948,127719483,102175586,0.028363749481885,0.10567178650534,
2020-09-19,73258,496224,569482,694121,124639,24280203,127719028,102175222,0.028587940553874,0.105540676625545,
2020-09-20,73493,499302,572795,697663,124868,24273301,127718793,102175034,0.028741991046047,0.105341690759005,
2020-09-21,73697,502982,576679,700580,123901,24266459,127718589,102174871,0.028870302008216,0.10519426760684,
2020-09-22,74348,506732,581080,705263,124183,24257245,127717938,102174350,0.02907432398032,0.10541882957138,
2020-09-23,74949,510237,585186,710049,124863,24248232,127717337,102173870,0.029282506040028,0.105554687070892,
2020-09-24,75439,514760,590199,715457,125258,24237713,127716847,102173478,0.029518337806872,0.105441696705742,
2020-09-25,75844,518204,594048,720858,126810,24228382,127716442,102173154,0.029752626485747,0.105213509456786,
2020-09-26,76243,521241,597484,726431,128947,24219294,127716043,102172834,0.02999389660161,0.104955597985218,
2020-09-27,76430,523831,600261,730317,130056,24212593,127715856,102172685,0.030162692612064,0.104653184849867,
2020-09-28,76603,527278,603881,733717,129836,24205539,127715683,102172546,0.03031194636897,0.104404014081724,
2020-09-29,77163,530945,608108,738163,130055,24196754,127715123,102172098,0.03050669523689,0.104533822475524,
2020-09-30,77646,533886,611532,743216,131684,24188180,127714640,102171712,0.030726412652792,0.104472993046436,
2020-10-01,78078,537475,615553,748315,132762,24178974,127714208,102171366,0.030948997256873,0.104338413635969,
2020-10-02,78492,541518,620010,753090,133080,24169659,127713794,102171035,0.031158486762267,0.104226586463769,
2020-10-03,78880,545530,624410,757953,133543,24160318,127713406,102170725,0.031371813897483,0.104069777413639,
2020-10-04,79088,550053,629141,761665,132524,24151834,127713198,102170558,0.031536528447488,0.103835675789225,
2020-10-05,81877,553937,635814,789780,153966,24116488,127710409,102168327,0.032748549457118,0.103670642457393,
2020-10-06,82348,557478,639826,794608,154782,24107554,127709938,102167950,0.032960954894055,0.103633489720718,
2020-10-07,82726,560895,643621,799188,155567,24099103,127709560,102167648,0.03316256210864,0.103512565253733,
2020-10-08,83096,583603,666699,804488,137789,24070651,127709190,102167352,0.033421946086959,0.103290540070206,
2020-10-09,83507,588085,671592,809751,138159,24060413,127708779,102167023,0.033654908583656,0.103126763659446,
2020-10-10,83642,591150,674792,814328,139536,24052609,127708644,102166915,0.033856119309136,0.102712911750548,
2020-10-11,83781,594180,677961,817503,139542,24046237,127708505,102166804,0.033997128116137,0.10248402758155,
2020-10-12,83945,597991,681936,821045,139109,24038687,127708341,102166673,0.034155151652002,0.102241655451285,
2020-10-13,84420,601571,685991,825340,139349,24030242,127707866,102166293,0.034345887985648,0.102285118860106,
2020-10-14,84898,603827,688725,829396,140671,24023357,127707388,102165910,0.034524567070289,0.102361236369599,
2020-10-15,85285,608188,693473,834910,141437,24013017,127707001,102165601,0.034769058798401,0.102148734594148,
2020-10-16,85704,612216,697920,841661,143741,24001735,127706582,102165266,0.035066673305076,0.101827220222869,
2020-10-17,86059,615680,701739,847108,145369,23992398,127706227,102164982,0.035307350269865,0.101591532602691,
2020-10-18,86167,619036,705203,851227,146024,23984794,127706119,102164895,0.035490277715122,0.101226817288455,
2020-10-19,86338,623494,709832,854926,145094,23976432,127705948,102164758,0.035656931773668,0.100988857515153,
2020-10-20,86893,627584,714477,860714,146237,23965888,127705393,102164314,0.03591412928242,0.100954556333463,
2020-10-21,87415,632037,719452,867559,148107,23953963,127704871,102163897,0.036217764885084,0.100759717782883,
2020-10-22,87894,636391,724285,874171,149886,23942422,127704392,102163514,0.036511385523152,0.100545545436762,
2020-10-23,88312,641075,729387,880775,151388,23930633,127703974,102163179,0.036805336490681,0.100266242797536,
2020-10-24,88743,646739,735482,886800,151318,23918427,127703543,102162834,0.037076016746419,0.100071041948579,
2020-10-25,88924,650355,739279,891160,151881,23910233,127703362,102162690,0.037271071344223,0.09978455047354,
2020-10-26,89171,655118,744289,895326,151037,23901008,127703115,102162492,0.037459759019369,0.099596124763494,
2020-10-27,89814,659473,749287,901268,151981,23889939,127702472,102161978,0.03772583931671,0.099652933422689,
2020-10-28,90309,663639,753948,906863,152915,23879584,127701977,102161582,0.037976499088091,0.099583950387214,
2020-10-29,90773,668667,759440,912811,153371,23868052,127701513,102161210,0.038244051085526,0.099443367794648,
2020-10-30,91289,673457,764746,918811,154065,23856642,127700997,102160798,0.038513844488256,0.099355580200934,
2020-10-31,91753,677659,769412,924962,155550,23845733,127700533,102160426,0.038789413602845,0.099196507532201,
2020-11-01,91895,682044,773939,929392,155453,23836747,127700391,102160313,0.038989883980394,0.098876469778092,
2020-11-02,92100,687420,779520,933155,153635,23827362,127700186,102160149,0.039163168797284,0.098697429687458,
2020-11-03,92593,693227,785820,938405,152585,23815714,127699693,102159754,0.039402765753737,0.098670616631412,
2020-11-04,93228,697402,790630,943630,153000,23805552,127699058,102159246,0.039639072431507,0.098797198054322,
2020-11-05,93772,701837,795609,949197,153588,23794897,127698514,102158811,0.03989077994328,0.098790872706087,
2020-11-06,94323,706267,800590,955128,154538,23783875,127697963,102158370,0.040158636891592,0.098754303088173,
2020-11-07,94808,710940,805748,961938,156190,23771810,127697478,102157982,0.040465492530859,0.098559366611985,
2020-11-08,95027,715977,811004,967825,156821,23760623,127697259,102157807,0.040732307397832,0.098186139023067,
2020-11-09,95225,721076,816301,972785,156484,23750326,127697061,102157649,0.040958806207544,0.097889050509619,
2020-11-10,95842,725846,821688,978531,156843,23739070,127696444,102157155,0.041220275267734,0.097944776404631,
2020-11-11,96430,731468,827898,986177,158279,23725096,127695856,102156685,0.041566828644234,0.097781635548183,
2020-11-12,97056,736197,833253,991835,158582,23713958,127695230,102156184,0.041824945460391,0.097854985960366,
2020-11-13,97624,741340,838964,997393,158429,23702575,127694662,102155730,0.042079520895936,0.097879170998794,
2020-11-14,98259,745361,843620,1003253,159633,23691932,127694027,102155222,0.042345765638699,0.097940399879193,
2020-11-15,98542,750190,848732,1006522,157790,23683495,127693744,102154995,0.042498879493926,0.097903473545536,
2020-11-16,98861,754200,853061,1009396,156335,23676228,127693425,102154740,0.042633311353481,0.09794074872498,
2020-11-17,99026,757951,856977,1011153,154176,23670522,127693260,102154608,0.042717815855519,0.097933744942655,
2020-11-18,99528,762025,861553,1015071,153518,23661928,127692758,102154206,0.042898913393702,0.098050284167314,
2020-11-19,100104,766361,866465,1019543,153078,23652428,127692182,102153746,0.04310521524471,0.098185167275927,
2020-11-20,100823,770728,871551,1025969,154418,23640773,127691463,102153170,0.043398284819198,0.09827100039085,
2020-11-21,101373,774930,876303,1032688,156385,23629192,127690913,102152730,0.043703906591474,0.098164208357219,
2020-11-22,101676,779104,880780,1041875,161095,23615467,127690610,102152488,0.044118331430837,0.097589442111578,
2020-11-23,101926,784693,886619,1049358,162739,23602095,127690360,102152288,0.044460375233639,0.097131770091809,
2020-11-24,102739,791516,894255,1060152,165897,23583502,127689547,102151638,0.044953120193939,0.096909688422038,
2020-11-25,103597,798037,901634,1070487,168853,23565617,127688689,102150951,0.045425799799768,0.096775579712785,
2020-11-26,104242,803581,907823,1078594,170771,23551192,127688044,102150435,0.045797851760539,0.096646189391004,
2020-11-27,104873,803581,908454,1090675,182221,23538354,127687413,102149930,0.046336077705349,0.096154216425608,
2020-11-28,105459,813254,918713,1100683,181970,23517969,127686827,102149462,0.04680178802855,0.095812327436692,
2020-11-29,105655,818397,924052,1107071,183019,23506203,127686631,102149305,0.047096972658664,0.09543651671844,
2020-11-30,105940,823586,929526,1113543,184017,23494200,127686346,102149077,0.047396506371785,0.095137771958514,
2020-12-01,106765,829817,936582,1122362,185780,23478160,127685521,102148417,0.047804512789759,0.095125280435368,
2020-12-02,107565,836567,944132,1133613,189481,23459199,127684721,102147777,0.048322749638639,0.094886879384764,
2020-12-03,108173,843231,951404,1144643,193239,23440776,127684113,102147290,0.048831275892914,0.094503701153984,
2020-12-04,108863,852719,961582,1156770,195188,23418333,127683423,102146738,0.049395915584598,0.09410945996179,
2020-12-05,109456,859463,968919,1168395,199476,23399252,127682830,102146264,0.049933006405504,0.093680647383804,
2020-12-06,109717,866186,975903,1175850,199947,23384761,127682569,102146055,0.05028274610119,0.093308670323596,
2020-12-07,110074,873555,983629,1182249,198620,23370564,127682212,102145770,0.050587097512923,0.093105597890123,
2020-12-08,110874,881050,991924,1193255,201331,23351103,127681412,102145130,0.051100583985262,0.092917272502525,
2020-12-09,111655,889168,1000823,1205229,204406,23330074,127680631,102144505,0.051659887576868,0.092642145185687,
2020-12-10,112326,896130,1008456,1217126,208670,23310410,127679960,102143968,0.052213839224621,0.092287897884032,
2020-12-11,113019,904042,1017061,1229379,212318,23289413,127679267,102143414,0.052787032459771,0.091931780191463,
2020-12-12,113704,911965,1025669,1241436,215767,23268611,127678582,102142866,0.053352389620506,0.091590706246637,
2020-12-13,113953,918681,1032634,1250044,217410,23252989,127678333,102142666,0.05375842219682,0.09115919119647,
2020-12-14,114298,927754,1042052,1255974,213922,23237572,127677988,102142390,0.054049278470229,0.091003476186609,
2020-12-15,115099,938089,1053188,1267202,214014,23215047,127677187,102141750,0.054585373012598,0.090829244272026,
2020-12-16,115769,945673,1061442,1277499,216057,23196362,127676517,102141214,0.055073248123995,0.090621597355458,
2020-12-17,116487,953762,1070249,1289298,219049,23175613,127675799,102140639,0.055631667649956,0.090349166755863,
2020-12-18,117249,962397,1079646,1301546,221900,23153815,127675037,102140030,0.05621302580158,0.090084407312535,
2020-12-19,117876,971115,1088991,1313675,224684,23132216,127674410,102139528,0.056789846679626,0.089729956039355,
2020-12-20,118202,978002,1096204,1320545,224341,23118068,127674084,102139267,0.057121771594408,0.089510012911336,
2020-12-21,118598,987328,1105926,1325915,219989,23102897,127673688,102138950,0.05739172018124,0.089446156050727,
2020-12-22,119495,996302,1115797,1338426,222629,23080335,127672791,102138233,0.057989886195326,0.089280244107631,
2020-12-23,120311,1005248,1125559,1350079,224520,23058757,127671975,102137580,0.05854951331505,0.0891140444374,
2020-12-24,121172,1015256,1136428,1362564,226136,23035231,127671114,102136891,0.05915130610151,0.088929400747415,
2020-12-25,121837,1023916,1145753,1372243,226490,23016094,127670449,102136359,0.059621019969766,0.088786752783581,
2020-12-26,122026,1031864,1153890,1377217,223327,23002945,127670260,102136208,0.059871333866164,0.088603321045267,
2020-12-27,122426,1038766,1161192,1383434,222242,22989346,127669860,102135888,0.060177179463914,0.08849428306663,
2020-12-28,122855,1048539,1171394,1389430,218036,22973062,127669431,102135545,0.060480836207207,0.088421151119524,
2020-12-29,123845,1058429,1182274,1401529,219255,22949885,127668441,102134753,0.061069107753699,0.088364207947178,
2020-12-30,124897,1066771,1191668,1413935,222267,22927875,127667389,102133911,0.061668820158868,0.088332914879397,
2020-12-31,125807,1074795,1200602,1426094,225492,22906600,127666479,102133183,0.062256904123702,0.088217887460434,
2021-01-01,126507,1083768,1210275,1437185,226910,22885696,127665779,102132623,0.062798395993725,0.088024158337305,
2021-01-02,126851,1090905,1217756,1443544,225788,22871787,127665435,102132348,0.063114613650433,0.087874702814739,
2021-01-03,127213,1098431,1225644,1448755,223111,22858616,127665073,102132058,0.0633789464769,0.087808497641078,
2021-01-04,127757,1105834,1233591,1455219,221628,22844096,127664529,102131623,0.063702192461457,0.087792284185404,
2021-01-05,128822,1113137,1241959,1466490,224531,22824244,127663464,102130771,0.064251416169578,0.087843762998725,
2021-01-06,129987,1119968,1249955,1479875,229920,22802630,127662299,102129839,0.06489931205304,0.087836472675057,
2021-01-07,131031,1127471,1258502,1493569,235067,22780180,127661255,102129004,0.065564407304947,0.087730128303413,
2021-01-08,132069,1134877,1266946,1507931,240985,22757166,127660217,102128174,0.066261809576816,0.087582919908139,
2021-01-09,133204,1143254,1276458,1524036,247578,22731322,127659082,102127266,0.06704563861266,0.087402134857707,
2021-01-10,133706,1150422,1284128,1534039,249911,22713549,127658580,102126864,0.067538498717219,0.08715945292134,
2021-01-11,134368,1160373,1294741,1541633,246892,22695210,127657918,102126334,0.067927681656173,0.087159524997195,
2021-01-12,135682,1168354,1304036,1556028,251992,22671257,127656604,102125283,0.068634394643403,0.087197659682217,
2021-01-13,136917,1176658,1313575,1571901,258326,22645598,127655369,102124295,0.069413092999355,0.087102813726819,
2021-01-14,137916,1185621,1323537,1588369,264832,22618968,127654370,102123496,0.07022287665821,0.086828690310627,
2021-01-15,139022,1199810,1338832,1609735,270903,22582086,127653264,102122611,0.071283715773645,0.086363283397578,
2021-01-16,140241,1212403,1352644,1630258,277614,22547507,127652045,102121636,0.072303248425646,0.086023807274677,
2021-01-17,140704,1223108,1363812,1641428,277616,22525076,127651582,102121266,0.072871141478058,0.085720482409219,
2021-01-18,141248,1237321,1378569,1649502,270933,22502137,127651038,102120830,0.073304237726399,0.085630693385034,
2021-01-19,142832,1251782,1394614,1668396,273782,22466881,127649454,102119563,0.074260241107789,0.085610370679383,
2021-01-20,144371,1264780,1409151,1688944,279793,22431488,127647915,102118332,0.07529344464353,0.085480039598708,
2021-01-21,146174,1277978,1424152,1711283,287131,22393787,127646112,102116890,0.076417758193378,0.085417783031796,
2021-01-22,147614,1291940,1439554,1732290,292736,22357090,127644672,102115738,0.077482802994486,0.085213214877417,
2021-01-23,149084,1306138,1455222,1752347,297125,22321071,127643202,102114562,0.078506403209774,0.08507675705782,
2021-01-24,149614,1320448,1470062,1763219,293157,22295253,127642672,102114138,0.079084951401987,0.08485276077447,
2021-01-25,150273,1335876,1486149,1771740,285591,22270514,127642013,102113610,0.079555415739394,0.084816620948898,
2021-01-26,152016,1348660,1500676,1788905,288229,22238473,127640270,102112216,0.080441899045856,0.084977122876844,
2021-01-27,153639,1362535,1516174,1806849,290675,22204706,127638647,102110918,0.081372345123597,0.085031455312536,
2021-01-28,155145,1376073,1531218,1825519,294301,22170691,127637141,102109713,0.082339291995906,0.08498679005806,
2021-01-29,156579,1390906,1547485,1841893,294408,22137763,127635707,102108566,0.083201405670483,0.085009824132021,
2021-01-30,158074,1403064,1561138,1857230,296092,22108474,127634212,102107370,0.08400534564258,0.085112775477458,
2021-01-31,158536,1412393,1570929,1864260,293331,22091561,127633750,102107000,0.084387880059721,0.085039640393507,
2021-02-01,159100,1452748,1611848,1869708,257860,22045081,127633186,102106549,0.08481293400555,0.085093501231208,
2021-02-02,159533,1436482,1596015,1874092,278077,22056444,127632753,102106202,0.084968003001753,0.085125490104008,
2021-02-03,161240,1450237,1611477,1886245,274768,22028487,127631046,102104837,0.085627533112011,0.085482002603055,
2021-02-04,162922,1461011,1623933,1899820,275887,22002120,127629364,102103491,0.08634713382165,0.085756545356929,
2021-02-05,164290,1472151,1636441,1912871,276430,21976287,127627996,102102397,0.087042501765653,0.085886607094781,
2021-02-06,165786,1482138,1647924,1926080,278156,21951296,127626500,102101200,0.087743338707655,0.086074306363183,
2021-02-07,166200,1490077,1656277,1932145,275868,21936795,127626086,102100869,0.088077816289937,0.086018388889033,
2021-02-08,166731,1501580,1668311,1936013,267702,21920787,127625555,102100444,0.088318590021426,0.086120806006985,
2021-02-09,168432,1511199,1679631,1946751,267120,21898389,127623854,102099083,0.088899279303149,0.086519539478855,
2021-02-10,169760,1519572,1689332,1957889,268557,21877284,127622526,102098021,0.089494152930501,0.086705630400906,
2021-02-11,171234,1528304,1699538,1968566,269028,21856106,127621052,102096842,0.090069383814299,0.086984129564363,
2021-02-12,172557,1535786,1708343,1978954,270611,21836649,127619729,102095783,0.090625351902666,0.087196064183402,
2021-02-13,173771,1542991,1716762,1988695,271933,21818246,127618515,102094812,0.091148252705557,0.087379412127048,
2021-02-14,174207,1548174,1722381,1992794,270413,21808441,127618079,102094463,0.091377187392717,0.087418468742881,
2021-02-15,174657,1555923,1730580,1995892,265312,21797054,127617629,102094103,0.091567053052215,0.087508241928922,
2021-02-16,175986,1563992,1739978,2004575,264597,21778707,127616300,102093040,0.092042883904908,0.087792175398775,
2021-02-17,177061,1571071,1748132,2013563,265431,21761350,127615225,102092180,0.092529323778166,0.087934174396331,
2021-02-18,178108,1577838,1755946,2022662,266716,21744228,127614178,102091342,0.09302063977622,0.088056234803442,
2021-02-19,178965,1584704,1763669,2030491,266822,21728504,127613321,102090657,0.093448265007108,0.088138780226064,
2021-02-20,179797,1590696,1770493,2038276,267783,21713729,127612489,102089991,0.093870380347844,0.088210330691231,
2021-02-21,180107,1595320,1775427,2041380,265953,21705629,127612179,102089743,0.094048414814424,0.088228061409439,
